-----B---B-----
---LPPPPPPPR---
-----S---------
---LPPPR-------
---------LPR---
--LPR----------
-------LPR-----
--LPR----------
--------LPR----
--LPR----------
-H-----------J-
PPPPPPPPPPPPPPP