-----B---------
--LPPPPPPPPPR--
--------B------
---LPPPPPPPR---
---------------
----LPPPPR----
--------S-----
---LPPPPPPPR---
----------S----
--LPPPPPPPPPR--
-H-----------J-
PPPPPPPPPPPPPPP