---------------
-LPR--LPR--LPR-
---------------
------LPR------
-------B-------
-LPR-LPPPR-LPR-
---------------
---LPR----LPR---
---------------
-LPR--LPR--LPR-
-H-----------J-
PPPPPPPPPPPPPPP