---------------
---LPR---LPR---
-------B-------
----LPPPPR-----
---------------
---LPR---LPR---
-------S-------
----LPPPPR-----
---------------
---LPR---LPR---
-H-----------J-
PPPPPPPPPPPPPPP